NO textures/self/heavy/harry_walls.xpm
SO textures/self/heavy/harry_walls.xpm
WE textures/self/heavy/harry_walls.xpm
EA textures/self/heavy/harry_walls.xpm
BO textures/self/heavy/harry_cup.xpm

F 13,13,12
C 12,16,39


111111111111111111111111111111
1N0000000000001000000100000001
101111101011110101111010111101
100000001010000101000010100001
111011111010111101011110101101
100010000010100001000010100001
101110111110101111111010111101
101000100000101000001010000101
101011101111101011101011111101
101000001000001000101000000001
101111101011111110101111111101
100000101010000000101000000001
111110101010111111101011111101
100010101000100000001000000101
101110101111101111111111110101
101000100000001000000000010001
101011111111101000000001010111
101000000000101000000001000001
101111111110101000000001111101
100000000010100000000101000001
111111011010111111110101011111
100000001010000000010101000001
101111101011111111010101111101
100000001000000001000100000001
101011111111111101111111111101
101011111111111100000000000001
111011111111111111111111111111
100000000000000000000000000021
101111111111111111111111111111
111111111111111111111111111111