NO textures/self/heavy/futuristic.xpm
SO textures/self/heavy/futuristic_cables.xpm
WE textures/self/heavy/futuristic_cables.xpm
EA textures/self/heavy/futuristic.xpm

F 16,17,21
C 31,32,33

1111111111111111111111111
1N00000000000000000000001
1011111111111111111111101
1010000000000000000000101
1010011111111111111100101
1010100000000000000010101
1010000000000000000010101
1010100000111110000010101
1010100000100010000010101
1010100000100000000010101
1000100000111110000010101
1010100000000000000000001
1010100000111110000000001
1010100000000010000010101
1000100000100010000010101
1010100000111110000010101
1010100000000000000010101
1010011111101111111100101
1010000000000000000000101
1011111111111111111111101
1000000000000000000000001
1000000000000000000000001
1000000000000000000000001
1000000000000000000000001
1111111111111111111111111



