NO textures/self/lightweight/retro_ice_sky-128x93.xpm
SO textures/self/lightweight/retro_ice_sky-128x93.xpm
WE textures/self/lightweight/retro_ice_sky-128x93.xpm
EA textures/self/lightweight/retro_ice_sky-128x93.xpm

F 213,233,237
C 225,226,232

11111111111111111111
1N000000000000000001
10000000000000000001
10000000010000000001
10000000111000000001
10000001111100000001
10000000111000000001
10000000010000000001
10000000000000000001
10000000000000000001
11111111101111111111
10001000100000100001
10101011101010101001
10100010001000100001
10111110111110111101
10000010000010000001
10111010101110101101
10100010100010100001
10000010000010000001
11111111111111111111