NO textures/self/lightweight/retro_moon-128x93.xpm
SO textures/self/lightweight/retro_moon-128x93.xpm
WE textures/self/lightweight/retro_moon-128x93.xpm
EA textures/self/lightweight/retro_moon-128x93.xpm

F 213,208,194
C 3,2,1

11111111111111111111
1N000000000000000001
10000000000000000001
10000000010000000001
10000000111000000001
10000001111100000001
10000000111000000001
10000000010000000001
10000000000000000001
10000000000000000001
11111111101111111111
10000000000000100001
10000000000000100001
10000011111000100001
10000010001000100001
10000010001000000001
10000011111000000001
10000000000000000001
10000000000000000001
11111111111111111111