NO textures/other/wolfenstein/red_brick.xpm
SO textures/other/wolfenstein/red_brick.xpm
WE textures/other/wolfenstein/red_brick.xpm
EA textures/other/wolfenstein/red_brick.xpm

F 120,120,120
C 70,130,180


11111111111111111111111111111111111
10000000000000000000000000000000001
10000000000000011000000000000000001
10000000000000011000000000000000001
10000000000000000000000000000000001
10000000000000000000000000000000001
10000000000000000000000000000000001
10000000000000000000000000000000001
10000000000000000000000000000000001
10000000000000000000000000000000001
100000000000000N0000000000000000001
10000000000000000000000000000000001
10000000000000000000000000000000001
10000000000000000000000000000000001
10000000000000000000000000000000001
10000000000000000000000000000000001
10000000000000000000000000000000001
10000000000000000000000000000000001
10000000000000000000000000000000001
10000000000000000000000000000000001
10000000000000000000000000000000001
10000000000000000000000000000000001
10000000000000000000000000000000001
10000000000000000000000000000000001
11111111111111111111111111111111111


