NO assets/textures/other/wolfenstein/grey_stone.xpm
SO assets/textures/other/wolfenstein/purple_stone.xpm
WE assets/textures/other/wolfenstein/red_brick.xpm
EA assets/textures/other/wolfenstein/wood.xpm
BO assets/textures/other/wolfenstein/mossy.xpm

F 34,139,34
C 135,206,235

1111111111111111111111111
1000000000000000000000001
1010002222202222200000101
1000002000000000200000001
1000002000020000200000001
1000002000000000200000001
1000002000000000200000001
1000002000000000200000001
10000020000S0000200000001
1000002000000000200000001
1000002222222222200000001
1000000000000000000000001
1010000000000000000000101
1000000000000000000000001
1111111111111111111111111